50000000000000000000000000000000000000000000000005
50000101000000000000000000000000000000000000000005
50001111100000000000000000000000000000000000000005
50000111000000000000000000000000000000000000000005
50000010000000000000000000000000000000000000000005
50000000000000000000000000000000000000000000000005
50000000000000000000000000000000000000000000000005
50000000000000000000000000000000000000000000000005
50000000000000000000000000000000000000000000000005
50000000000000000000000000000000000000000000000005
50000000000000000000000000000000000000000000000005
50000000000000000000000000000000000000000000000005
50000000000000000000000000000000000000000000000005
50000000000000444400000000000000000000000000000005
50000000000044440000000000000000000000000000000005
50000000000000004444000000000000000000000000000005
50000000000444444444400000000000000000000000000005
50000000000000000000000000000000000000000000000005
50000000000000000000000000000000000000000000000005
50000000000000000000000000000000000000000000000005
50000000000000000000000000000000000000000000000005
50000000010000000000000000000000000000000000000005
50000000000000000000000000000000000000000000000005
50000000000000000000000000000000000000000000000005
50000000000000000000000000000000000000000000000005
50000001100000000000000000000000000000000000000005
50000000000000000000000000000000000000000000000005
50000000000000000000000000000000000000000000000005
50000000000000000000010000000000000000000000000005
50000000000000000000000000000000000000000000000005
50000000000000000000000000000000000000000000000005
50000000000000000000000000000000000000000000000005
50000000000000000000000000000000000000000000000005
50000000000000000000000000000000000000000000000005
50000000000000000000000000000000000000000000000005
50000000000000000000000000000000000000000000000005
50000000000000000000000000000000000000000000000005
50000000000000000000000000000000000000000000000005
50000000000000000000000000000000000000000000000005
50000000000000000000000000000000000000000000000005
50000000000000000000000000000000000000000000000005
50000000000000000000000000000000000000000000000005
50000000000000000000000000000000000000000000000005
50000000000000000000000000000000000000000000000005
50000000000000000000000000000000000000000000000005
50000000000000000000000000000000000000000000000005
50000000000000000000000000000000000000000000000005
50000000000000000000000000000000000000000000000005
50000000000000000000000000000000000000000000000005
50000000000000000000000000000000000000000000000005