1001111111111111
1000000000000001
1000000000000001
1000000000000001
1000000000000001
1000000000000001
1000000000000001
1000022220000001
1000022220000001
1000022220000001
1000022220000001
1111111111111111
